{
    "tube_size": 4,
    "tubes": [   [7,1,2,1],
                [3,4,7,5],
                [1,6,6,2],
                [7,3,3,2],
                [4,4,2,5],
                [1,5,6,6],
                [5,7,3,4],
                [],
                []]
}