{
    "tube_size": 4,
    "tubes": [   
        [1,2,3,3],
        [4,5,6,2],
        [7,6,3,5],
        [2,5,3,8],
        [7,2,8,7],
        [1,1,9,4],
        [8,9,4,6],
        [5,9,7,4],
        [8,6,1,9],
        [],
        []
    ]
}